1111111111111111111111111
1000000000000000000000001
100000E00000000C000000001
1000000000P00000000000001
100000000000000C000000011
10000000000000000000000C1
1111111111111111111111111