11111111111
10EC0000001
10011010011
1P010100101
100100000C1
11111111111
