1111111111111111111
100P100000000000001
100010001110000C001
111010001C00000E001
1000000000000000001
1111111111111111111